Regions=ФРГ,ГДР,Дания,Нидерланды,Бельгия,Швеция,Норвегия,Исландия,Британия,Финляндия,СССР
//из Москвы	=		по Москве		=	про Москву		=	с Москвой		=	в Москве
//<LANDLOCAL_RO>	<LANDLOCAL_DA>		<LANDLOCAL_VI>		<LANDLOCAL_TV>		<LANDLOCAL_PR>
Regions_RO=ФРГ,ГДР,Дании,Нидерландов,Бельгии,Швеции,Норвегии,Исландии,Британии,Финляндии,СССР
Regions_DA=ФРГ,ГДР,Дании,Нидерландам,Бельгии,Швеции,Норвегии,Исландии,Британии,Финляндии,СССР
Regions_VI=ФРГ,ГДР,Данию,Нидерланды,Бельгию,Швецию,Норвегию,Исландию,Британию,Финляндию,СССР
Regions_TV=ФРГ,ГДР,Данией,Нидерландами,Бельгией,Швецией,Норвегией,Исландией,Британией,Финляндией,СССР
Regions_PR=ФРГ,ГДР,Дании,Нидерландах,Бельгии,Швеции,Норвегии,Исландии,Британии,Финляндии,СССР
Торсхавн=Дания,Торсхавна,Торсхавну,Торсхавн,Торсхавном,Торсхавне
Рейкьявик=Исландия,Рейкьявика,Рейкьявику,Рейкьявик,Рейкьявиком,Рейкьявике
Хёбн=Исландия,Хёбна,Хёбну,Хёбн,Хёбном,Хёбне
Франкфурт=ФРГ,Франкфурта,Франкфурту,Франкфурт,Франкфуртом,Франкфурте
Гамбург=ФРГ,Гамбурга,Гамбургу,Гамбург,Гамбургом,Гамбурге
North Rhine-Westphalia=ФРГ
Амстердам=Нидерланды,Амстердама,Амстердаму,Амстердам,Амстердамом,Амстердаме
Brussels, Antwerp and Charleroi=Бельгия
Копенгаген=Дания,Копенгагена,Копенгагену,Копенгаген,Копенгагеном,Копенгагене
Алта=Норвегия,Алты,Алте,Алту,Алтой,Алте
Аннёйа=Норвегия,Аннёйи,Аннёйе,Аннёйю,Аннёйей,Аннёйе
Нарвик=Норвегия,Нарвика,Нарвику,Нарвик,Нарвиком,Нарвике
central Norway=Норвегия
Тронхейм=Норвегия,Тронхейма,Тронхейму,Тронхейм,Тронхеймом,Тронхейме
Берген=Норвегия,Бергена,Бергену,Берген,Бергеном,Бергене
Oсло=Норвегия,Oсло,Oсло,Oсло,Oсло,Oсло
Стокгольм=Швеция,Стокгольма,Стокгольму,Стокгольм,Стокгольмом,Стокгольме
central Sweden=Швеция
Гремиха=СССР,Гремихи,Гремихе,Гремиху,Гремихой,Гремихе
Архангельск=СССР,Архангельска,Архангельску,Архангельск,Архангельском,Архангельске
Москва=СССР,Москвы,Москве,Москву,Москвой,Москве
Ленинград=СССР,Ленинграда,Ленинграду,Ленинград,Ленинградом,Ленинграде
Смоленск=СССР,Смоленска,Смоленску,Смоленск,Смоленском,Смоленске
Псков=СССР,Пскова,Пскову,Псков,Псковом,Пскове
Таллин=СССР,Таллина,Таллину,Таллин,Таллином,Таллине
Рига=СССР,Риги,Риге,Ригу,Ригой,Риге
Вильнюс=СССР,Вильнюса,Вильнюсу,Вильнюс,Вильнюсом,Вильнюсе
Калининград=СССР,Калининграда,Калининграду,Калининград,Калининградом,Калининграде
Портсмут=Британия,Портсмута,Портсмуту,Портсмут,Портсмутом,Портсмуте
Лондон=Британия,Лондона,Лондону,Лондон,Лондоном,Лондоне